1111111111111
10010E00C00C1
10P0011111001
1P0011E0C0001
1111111111111
1111111111111
1111111111111
1111111111111
1111111111111
1111111111111