1111111111111111111
1P01000000000001001
100CCCCCCCCCCCCC001
100C00010000110C011
100C00110001001C001
100C01010000010C001
100C11111000100C001
110C00010001111C011
100CCCCCCCCCCCCC001
10010000000000010E1
1111111111111111111