1111111111111111111
1P00CCCCCCCCCCC0001
100CCCCCCCCCCCCC001
10CC00010000110CC01
1CCC00110001001CCC1
1CCC01010000010CCC1
1CCC11111000100CCC1
10CC00010001111CC01
100CCCCCCCCCCCCC001
1000CCCCCCCCCCC00E1
1111111111111111111