1111111111111111111
1P010CCCCCCCCC01001
1001CCCCCCCCCCC1001
100CCCCCCCCCCCCC001
110C00010000110C011
1C0C00110001001C0C1
1C0C01010000010C0C1
1C0C11111000100C0C1
110C00010001111C011
100CCCCCCCCCCCCC001
1001CCCCCCCCCCC10E1
10010CCCCCCCCC01001
1111111111111111111