1111111111111111111
1P00000000000000001
100CCCCCCCCCCCCC001
100C00010000110C001
100C00110001001C001
100C01010000010C001
100C11111000100C001
100C00010001111C001
100CCCCCCCCCCCCC001
10000000000000000E1
1111111111111111111