1111111111111111111
1P010L0001100001001
100CCCCCCCCCCCCC001
1L0C00010000110C011
100C00110L01001C001
10LC01010000010C001
100C11111000100C001
100C0001L001111C011
111CCCCCCCCCCCCC001
11110000011000010E1
1111111111111111111