1111111111111111111
1P010L0001100001001
100CCCCCCCCCCCCC001
1L0C00010000110CL11
100C00110L01001C001
10LC0101000L010C0L1
100C11111000100C001
100C0001L001111C011
111CCCCCCCCCCCCC0L1
10010000011000010E1
1111111111111111111