11111111111111111111
1E000C00000C00000001
10100010100100L10101
101001L0100100010101
1P000000LC00C00000C1
11111111111111111111