11111111111111111111
1E000C000L0C00000001
10100010100100010101
10100100100100010101
10000C00000C0000L001
101000101L0100L10101
10100100100100010101
100000000C00C00000C1
1P0000000C00CL0000C1
11111111111111111111