11111111111
100P00000C1
100000E0001
11111111111