1111111111111
10010000C00C1
1000011111001
1P0011E0C0001
1111111111111
1111111111111
1111111111111
1111111111111
1111111111111
1111111111111
