11111111111
100P0000001
100000E0001
11111111111